1111111111111111111111111111111111111111111111111111111
1100000000000000000000000111110000000000000000000000011
1101111111110111111111110111110111111111110111111111011
1101111111110111111111110111110111111111110111111111011
1100000000000111110000000000000000000111110000000000011
1101111111110111110111111111111111110111110111111111011
1101111111110111110111111111111111110111110111111111011
1100000000000000000000000111110000000000000000000000011
1111111111110111111111110111110111111111110111111111111
1111111111110111111111110111110111111111110111111111111
1111111111110111110000000000000000000111110111111111111
1111111111110111110111111100011111110111110111111111111
1111111111110111110110000000000000110111110111111111111
0000000000000000000110000000000000110000000000000000000
1111111111110111110110000000000000110111110111111111111
1111111111110111110111111111111111110111110111111111111
1111111111110111110000000000000000000111110111111111111
1111111111110111111111111111111111111111110111111111111
1111111111110111111111111111111111111111110111111111111
1100000000000000000000000111110000000000000000000000011
1101111111110111111111110111110111111111110111111111011
1101111111110111111111110111110111111111110111111111011
1100000111110000000000000000000000000000000111110000011
1111110111110111110111111111111111110111110111110111111
1111110111110111110111111111111111110111110111110111111
1100000000000111110000000111110000000111110000000000011
1101111111111111111111110111110111111111111111111111011
1101111111111111111111110111110111111111111111111111011
1100000000000000000000000000000000000000000000000000011
1111111111111111111111111111111111111111111111111111111