0000000000000000000000000000000000000000000000000000000
0011111111111111111111111000001111111111111111111111100
0010000000001000000000001000001000000000001000000000100
0020000000001000000000001000001000000000001000000000200
0011111111111000001111111111111111111000001111111111100
0010000000001000001000000000000000001000001000000000100
0010000000001000001000000000000000001000001000000000100
0011111111111111111111111000001111111111111111111111100
0000001000001000001000001000001000001000001000001000000
0000001000001000001000001000001000001000001000001000000
0111111111111111111111111112111111111111111111111111110
0100001000001000001000001111111000001000001000001000010
0111111111111111111111111112111111111111111111111111110
0100001000001000001000001000001000001000001000001000010
0111111111111111111111111111111111111111111111111111110
0000001000001000001000000000000000001000001000001000000
0000001000001000001111111111111111111000001000001000000
0000001000001000000010000000000000100000001000001000000
0000001000001000000010000000000000100000001000001000000
0011111111111111111111111000001111111111111111111111100
0010000000001000000000001000001000000000001000000000100
0010000000001000000000001000001000000000001000000000100
0011111000001111111111111111111111111111111000001111100
0000001000001000001000000000000000001000001000001000000
0000001000001000001000000000000000001000001000001000000
0011111111111000001111111000001111111000001111111111100
0020000000001000000000001000001000000000001000000000200
0010000000001000000000001000001000000000001000000000100
0011111111111111111111111111111111111111111111111111100
0000000000000000000000000000000000000000000000000000000